AUD: Australian Dollar ğŸ‡¦ğŸ‡º
BGN: Bulgarian Lev ğŸ‡§ğŸ‡¬
BRL: Brazilian Real ğŸ‡§ğŸ‡·
CAD: Canadian Dollar ğŸ‡¨ğŸ‡¦
CHF: Swiss Franc ğŸ‡¨ğŸ‡­
CNY: Chinese Yuan ğŸ‡¨ğŸ‡³
CZK: Czech Koruna ğŸ‡¨ğŸ‡¿
DKK: Danish Krone ğŸ‡©ğŸ‡°
EUR: Euro ğŸ‡ªğŸ‡º
GBP: Pound Sterling ğŸ‡¬ğŸ‡§
HKD: Honkgong Dollar ğŸ‡­ğŸ‡°
HRK: Croatian Kuna ğŸ‡­ğŸ‡·
HUF: Hungarian Forint ğŸ‡­ğŸ‡º
IDR: Indonesian Rupiah ğŸ‡®ğŸ‡©
ILS: Israeli New Shekel ğŸ‡®ğŸ‡±
INR: Indian Rupee ğŸ‡®ğŸ‡³
ISK: Icelandic Krona ğŸ‡®ğŸ‡¸
JPY: Japanese Yen ğŸ‡¯ğŸ‡µ
KRW: South Korean Won ğŸ‡°ğŸ‡·
MXN: Mexican Peso ğŸ‡²ğŸ‡½
MYR: Malaysian Ringgit ğŸ‡²ğŸ‡¾
NOK: Norwegian Krone ğŸ‡³ğŸ‡´
NZD: New Zealand Dollar ğŸ‡³ğŸ‡¿
PHP: Philippine Peso ğŸ‡µğŸ‡­
PLN: Polish Zloty ğŸ‡µğŸ‡±
RON: Romanian Leu ğŸ‡·ğŸ‡´
RUB: Russian Ruble ğŸ‡·ğŸ‡º
SEK: Swedish Krona ğŸ‡¸ğŸ‡ª
SGD: Singapore Dollar ğŸ‡¸ğŸ‡¬
THB: Thai Baht ğŸ‡¹ğŸ‡­
TRY: Turkish Lira ğŸ‡¹ğŸ‡·
USD: American Dollar ğŸ‡ºğŸ‡¸
ZAR: South African Rand ğŸ‡¿ğŸ‡¦